10 10 4
BUS 1 1 1 4 3 0 0
BUS 2 8 8 3 3 0 0
BUS 3 5 0 2 3 0 0
BUS 4 9 4 3 3 0 0
CAR 1 0 6 2 2 0 0
CAR 2 2 9 1 2 0 0
CAR 3 4 4 4 2 0 0
CAR 4 7 1 4 2 0 0
CAR 1 6 7 1 2 0 0
CAR 2 3 3 2 2 0 0
-
1 2 3 4 1 2 3 4 1 2 3 4 2 1 3 4