8 8 4
CAR 2 0 5 2 2 0 0
CAR 3 4 0 4 2 0 0
BUS 4 7 6 3 2 0 0
CAR 1 5 4 1 2 0 0
CAR 2 3 7 1 2 0 0
BUS 3 6 2 4 2 0 0
CAR 4 0 2 2 2 0 0
BUS 2 4 6 3 2 0 0
-
1 2 3 4 1 2 3 4 2 1