8 8 4
BUS 1 0 0 2 3 0 0
CAR 2 3 4 4 2 0 0
CAR 3 2 2 4 2 0 0
BUS 1 5 5 2 3 0 0
CAR 2 0 4 4 2 0 0
CAR 1 3 6 4 2 0 0
- 
2 3 1 1 2 3 2 1 2